"aa" = (/turf/space,/area/space)
"ab" = (/turf/simulated/wall/r_wall/hull,/area/space)
"ac" = (/turf/simulated/floor/plating,/area/space)
"ad" = (/turf/simulated/wall/prepainted,/area/space)
"ae" = (/turf/simulated/floor/tiled,/area/space)
"af" = (/turf/simulated/wall/r_wall/prepainted,/area/space)
"ag" = (/turf/unsimulated/mask,/area/space)
"ah" = (/turf/simulated/floor/tiled/monotile,/area/space)
"ai" = (/obj/machinery/door/airlock/hatch/maintenance,/turf/simulated/floor/plating,/area/space)
"aj" = (/turf/simulated/floor/grass,/area/space)
"ak" = (/obj/machinery/door/airlock/multi_tile/civilian,/turf/simulated/floor/tiled/monotile,/area/space)
"al" = (/obj/machinery/power/apc{dir = 1; name = "north bump"; pixel_x = 0; pixel_y = 24; req_access = list(11)},/turf/simulated/floor/plating,/area/space)
"am" = (/obj/machinery/atmospherics/pipe/tank/air,/turf/simulated/floor/tiled,/area/space)
"an" = (/obj/effect/wallframe_spawn/reinforced/hull,/turf/simulated/floor/plating,/area/space)
"ao" = (/obj/machinery/atmospherics/pipe/tank/oxygen,/turf/simulated/floor/tiled,/area/space)
"ap" = (/obj/effect/catwalk_plated,/turf/simulated/floor/plating,/area/space)
"aq" = (/obj/machinery/door/airlock/civilian,/turf/simulated/floor/tiled/monotile,/area/space)
"ar" = (/obj/machinery/atmospherics/pipe/tank/nitrogen,/turf/simulated/floor/tiled,/area/space)
"as" = (/obj/machinery/atmospherics/pipe/tank/carbon_dioxide,/turf/simulated/floor/tiled,/area/space)
"at" = (/obj/machinery/atmospherics/pipe/tank/hydrogen,/turf/simulated/floor/tiled,/area/space)
"au" = (/obj/machinery/atmospherics/pipe/tank/phoron,/turf/simulated/floor/tiled,/area/space)
"av" = (/turf/simulated/wall/r_wall/prepainted,/area/hallway/primary)
"aw" = (/obj/machinery/atmospherics/pipe/manifold/visible/blue{dir = 8},/turf/simulated/floor/tiled,/area/space)
"ax" = (/obj/machinery/atmospherics/pipe/manifold/visible/blue{dir = 4},/turf/simulated/floor/tiled,/area/space)
"ay" = (/obj/machinery/atmospherics/trinary/mixer/m_mixer,/turf/simulated/floor/tiled,/area/space)
"az" = (/obj/machinery/atmospherics/pipe/simple/visible/green{dir = 9; icon_state = "intact"},/turf/simulated/floor/tiled,/area/space)
"aA" = (/obj/effect/wallframe_spawn/reinforced_phoron,/turf/simulated/floor/plating,/area/space)
"aB" = (/obj/machinery/atmospherics/unary/engine{dir = 8},/turf/simulated/floor/plating,/area/space)
"aC" = (/turf/unsimulated/mask,/area/hallway/primary)
"aD" = (/obj/machinery/atmospherics/pipe/simple/visible/blue,/turf/simulated/floor/tiled/monotile,/area/space)
"aE" = (/obj/machinery/atmospherics/pipe/simple/visible/cyan{icon_state = "intact"; dir = 5},/turf/simulated/floor/tiled/monotile,/area/space)
"aF" = (/obj/machinery/atmospherics/pipe/simple/visible/cyan{icon_state = "intact"; dir = 9},/turf/simulated/floor/tiled/monotile,/area/space)
"aG" = (/obj/machinery/atmospherics/binary/pump/on,/turf/simulated/floor/tiled/monotile,/area/space)
"aH" = (/obj/machinery/power/apc{dir = 2; name = "south bump"; operating = 1; pixel_y = -28},/turf/simulated/floor/tiled,/area/space)
"aI" = (/obj/machinery/atmospherics/pipe/simple/hidden/blue,/obj/structure/cable{d1 = 2; d2 = 4; icon_state = "2-4"},/turf/simulated/floor/tiled/monotile,/area/space)
"aJ" = (/obj/structure/cable{d1 = 4; d2 = 8; icon_state = "4-8"},/turf/simulated/floor/tiled/monotile,/area/space)
"aK" = (/obj/machinery/power/apc{dir = 2; name = "south bump"; operating = 1; pixel_y = -28},/obj/structure/cable{d2 = 8; icon_state = "0-8"},/turf/simulated/floor/tiled/monotile,/area/space)
"aL" = (/obj/machinery/atmospherics/unary/vent_pump/on{dir = 2; layer = 2.4; level = 2},/turf/simulated/floor/tiled,/area/space)
"aM" = (/obj/machinery/atmospherics/unary/vent_scrubber/on,/turf/simulated/floor/tiled,/area/space)
"aN" = (/turf/simulated/floor/grass,/area/hallway/primary)
"aO" = (/obj/machinery/door/airlock/multi_tile/civilian,/obj/machinery/atmospherics/pipe/simple/hidden/blue,/obj/structure/cable{d1 = 1; d2 = 2; icon_state = "1-2"; pixel_y = 0},/turf/simulated/floor/tiled/monotile,/area/space)
"aP" = (/obj/machinery/door/airlock/multi_tile/civilian,/turf/simulated/floor/tiled,/area/space)
"aQ" = (/obj/machinery/atmospherics/pipe/simple/hidden/supply{dir = 5},/turf/simulated/floor/tiled,/area/space)
"aR" = (/obj/machinery/atmospherics/pipe/simple/hidden/supply{dir = 10},/turf/simulated/floor/tiled,/area/space)
"aS" = (/obj/turbolift_map_holder/untitled,/turf/unsimulated/mask,/area/hallway/primary)
"aT" = (/obj/machinery/atmospherics/pipe/simple/hidden/blue,/obj/structure/cable{d1 = 1; d2 = 2; icon_state = "1-2"; pixel_y = 0},/turf/simulated/floor/tiled/monotile,/area/hallway/primary)
"aU" = (/turf/simulated/floor/tiled/monotile,/area/hallway/primary)
"aV" = (/turf/simulated/wall/r_wall/prepainted,/area/engineering/engine_room)
"aW" = (/turf/simulated/floor/tiled,/area/engineering/engine_room)
"aX" = (/turf/simulated/wall/r_wall/hull,/area/engineering/engine_room)
"aY" = (/obj/machinery/atmospherics/unary/vent_scrubber/on{dir = 4},/turf/simulated/floor/tiled/monotile,/area/space)
"aZ" = (/obj/machinery/door/airlock/multi_tile/civilian,/obj/machinery/atmospherics/pipe/simple/hidden/supply,/turf/simulated/floor/tiled/monotile,/area/space)
"ba" = (/turf/simulated/floor/tiled/steel_ridged,/area/hallway/primary)
"bb" = (/obj/machinery/atmospherics/pipe/simple/hidden/universal,/obj/structure/cable{d1 = 1; d2 = 2; icon_state = "1-2"; pixel_y = 0},/turf/simulated/floor/tiled/monotile,/area/hallway/primary)
"bc" = (/obj/machinery/power/apc{dir = 4; name = "east bump"; pixel_x = 24},/turf/simulated/floor/tiled,/area/engineering/engine_room)
"bd" = (/obj/machinery/atmospherics/pipe/simple/hidden/supply{dir = 6},/turf/simulated/floor/tiled/monotile,/area/space)
"be" = (/obj/machinery/atmospherics/pipe/simple/hidden/supply{dir = 4},/turf/simulated/floor/tiled/monotile,/area/hallway/primary)
"bf" = (/obj/machinery/atmospherics/pipe/manifold4w/hidden/supply,/turf/simulated/floor/tiled/monotile,/area/hallway/primary)
"bg" = (/obj/machinery/atmospherics/pipe/manifold/hidden/supply{dir = 1},/turf/simulated/floor/tiled/monotile,/area/hallway/primary)
"bh" = (/obj/machinery/atmospherics/pipe/manifold4w/hidden/supply,/obj/structure/cable{d1 = 1; d2 = 2; icon_state = "1-2"; pixel_y = 0},/turf/simulated/floor/tiled/monotile,/area/hallway/primary)
"bi" = (/obj/machinery/atmospherics/pipe/simple/hidden/supply{dir = 4},/turf/simulated/floor/tiled/monotile,/area/engineering/engine_room)
"bj" = (/obj/machinery/atmospherics/pipe/simple/hidden/supply{dir = 4},/turf/simulated/floor/tiled,/area/engineering/engine_room)
"bk" = (/obj/machinery/atmospherics/unary/vent_pump/on{dir = 8},/turf/simulated/floor/tiled,/area/engineering/engine_room)
"bl" = (/obj/machinery/door/airlock/multi_tile/civilian{dir = 4},/obj/machinery/atmospherics/pipe/simple/hidden/supply{dir = 6},/obj/structure/cable{d1 = 2; d2 = 4; icon_state = "2-4"},/turf/simulated/floor/tiled/monotile,/area/space)
"bm" = (/obj/machinery/atmospherics/pipe/simple/hidden/supply{dir = 9; pixel_y = 0},/obj/structure/cable{d1 = 4; d2 = 8; icon_state = "4-8"},/turf/simulated/floor/tiled/monotile,/area/space)
"bn" = (/obj/machinery/atmospherics/unary/vent_scrubber/on{dir = 1},/obj/structure/cable{d1 = 4; d2 = 8; icon_state = "4-8"},/turf/simulated/floor/tiled/monotile,/area/hallway/primary)
"bo" = (/obj/structure/cable{d1 = 4; d2 = 8; icon_state = "4-8"},/turf/simulated/floor/tiled/monotile,/area/hallway/primary)
"bp" = (/obj/machinery/atmospherics/pipe/simple/hidden/supply,/obj/structure/cable{d1 = 4; d2 = 8; icon_state = "4-8"},/turf/simulated/floor/tiled/monotile,/area/hallway/primary)
"bq" = (/obj/machinery/atmospherics/unary/vent_pump/on{dir = 1; layer = 2.4; level = 2},/obj/structure/cable{d1 = 4; d2 = 8; icon_state = "4-8"},/turf/simulated/floor/tiled/monotile,/area/hallway/primary)
"br" = (/obj/effect/catwalk_plated,/obj/machinery/atmospherics/pipe/simple/hidden/supply,/obj/structure/cable{d1 = 4; d2 = 8; icon_state = "4-8"},/obj/structure/cable{d1 = 2; d2 = 4; icon_state = "2-4"},/turf/simulated/floor/plating,/area/hallway/primary)
"bs" = (/obj/machinery/atmospherics/pipe/simple/hidden/supply,/obj/structure/cable{d1 = 1; d2 = 4; icon_state = "1-4"},/obj/structure/cable{d1 = 2; d2 = 4; icon_state = "2-4"},/obj/structure/cable{d1 = 4; d2 = 8; icon_state = "4-8"},/turf/simulated/floor/tiled/monotile,/area/hallway/primary)
"bt" = (/obj/machinery/door/airlock/multi_tile/civilian{dir = 4},/obj/structure/cable{d1 = 4; d2 = 8; icon_state = "4-8"},/turf/simulated/floor/tiled/monotile,/area/hallway/primary)
"bu" = (/obj/structure/cable{d1 = 4; d2 = 8; icon_state = "4-8"},/turf/simulated/floor/tiled/monotile,/area/engineering/engine_room)
"bv" = (/obj/structure/cable{d1 = 4; d2 = 8; icon_state = "4-8"},/turf/simulated/floor/tiled,/area/engineering/engine_room)
"bw" = (/obj/machinery/power/debug_items/infinite_generator,/turf/simulated/floor/tiled,/area/engineering/engine_room)
"bx" = (/obj/machinery/atmospherics/unary/vent_pump/on{dir = 4; layer = 2.4; level = 2},/turf/simulated/floor/tiled/monotile,/area/space)
"by" = (/obj/machinery/atmospherics/pipe/simple/hidden/supply{dir = 9; pixel_y = 0},/obj/structure/cable{d1 = 1; d2 = 2; icon_state = "1-2"; pixel_y = 0},/turf/simulated/floor/grass,/area/space)
"bz" = (/obj/machinery/atmospherics/pipe/simple/hidden/supply,/turf/simulated/floor/tiled/monotile,/area/space)
"bA" = (/obj/effect/catwalk_plated,/obj/machinery/atmospherics/pipe/simple/hidden/supply,/obj/structure/cable{d1 = 1; d2 = 2; icon_state = "1-2"; pixel_y = 0},/turf/simulated/floor/plating,/area/hallway/primary)
"bB" = (/obj/machinery/atmospherics/pipe/simple/hidden/supply,/turf/simulated/floor/tiled/monotile,/area/hallway/primary)
"bC" = (/obj/machinery/power/apc{dir = 2; name = "south bump"; operating = 1; pixel_y = -28},/obj/structure/cable,/turf/simulated/floor/grass,/area/space)
"bD" = (/obj/machinery/atmospherics/pipe/simple/hidden/supply,/turf/simulated/floor/tiled,/area/space)
"bE" = (/obj/structure/stairs/west,/obj/structure/railing/mapped,/obj/structure/railing/mapped{dir = 1; icon_state = "railing0-1"},/turf/simulated/floor/grass,/area/hallway/primary)
"bF" = (/obj/structure/railing/mapped,/obj/structure/railing/mapped{dir = 1; icon_state = "railing0-1"},/turf/simulated/floor/grass,/area/hallway/primary)
"bG" = (/obj/machinery/atmospherics/pipe/simple/hidden/supply,/obj/structure/cable{d1 = 1; d2 = 2; icon_state = "1-2"; pixel_y = 0},/turf/simulated/floor/tiled/monotile,/area/hallway/primary)
"bH" = (/turf/simulated/wall/prepainted,/area/hallway/primary)
"bI" = (/obj/machinery/atmospherics/pipe/simple/hidden/supply{dir = 6},/obj/structure/cable{d1 = 2; d2 = 4; icon_state = "2-4"},/turf/simulated/floor/grass,/area/hallway/primary)
"bJ" = (/obj/machinery/atmospherics/pipe/simple/hidden/supply{dir = 4},/obj/structure/cable{d1 = 4; d2 = 8; icon_state = "4-8"},/turf/simulated/floor/grass,/area/hallway/primary)
"bK" = (/obj/machinery/atmospherics/pipe/simple/hidden/supply{dir = 4},/obj/structure/cable{d1 = 4; d2 = 8; icon_state = "4-8"},/turf/simulated/floor/tiled/monotile,/area/hallway/primary)
"bL" = (/obj/effect/catwalk_plated,/obj/machinery/atmospherics/pipe/manifold4w/hidden/supply,/obj/structure/cable{d1 = 1; d2 = 2; icon_state = "1-2"; pixel_y = 0},/obj/structure/cable{d1 = 1; d2 = 8; icon_state = "1-8"},/obj/structure/cable{d1 = 1; d2 = 4; icon_state = "1-4"},/turf/simulated/floor/plating,/area/hallway/primary)
"bM" = (/obj/machinery/atmospherics/pipe/simple/hidden/supply{dir = 10},/obj/structure/cable{d1 = 2; d2 = 8; icon_state = "2-8"},/turf/simulated/floor/grass,/area/hallway/primary)
"bN" = (/obj/machinery/atmospherics/pipe/simple/hidden/supply{dir = 6},/turf/simulated/floor/tiled,/area/space)
"bO" = (/obj/machinery/atmospherics/pipe/simple/hidden/supply{dir = 9; pixel_y = 0},/turf/simulated/floor/tiled,/area/space)
"bP" = (/obj/machinery/atmospherics/unary/vent_scrubber/on{dir = 1},/turf/simulated/floor/tiled,/area/space)
"bQ" = (/obj/machinery/door/airlock/civilian,/obj/machinery/atmospherics/pipe/simple/hidden/supply,/obj/structure/cable{d1 = 1; d2 = 2; icon_state = "1-2"; pixel_y = 0},/turf/simulated/floor/tiled/monotile,/area/space)
"bR" = (/obj/effect/catwalk_plated,/obj/structure/cable{d1 = 1; d2 = 2; icon_state = "1-2"; pixel_y = 0},/turf/simulated/floor/plating,/area/hallway/primary)
"bS" = (/obj/machinery/atmospherics/pipe/manifold/hidden/supply{dir = 8},/turf/simulated/floor/tiled/monotile,/area/hallway/primary)
"bT" = (/obj/machinery/atmospherics/pipe/simple/hidden/supply{dir = 10},/turf/simulated/floor/tiled/monotile,/area/hallway/primary)
"bU" = (/obj/machinery/atmospherics/unary/vent_pump/on{dir = 4; layer = 2.4; level = 2},/turf/simulated/floor/tiled,/area/space)
"bV" = (/obj/machinery/atmospherics/pipe/simple/hidden/supply{dir = 5},/obj/structure/cable{d1 = 1; d2 = 2; icon_state = "1-2"; pixel_y = 0},/turf/simulated/floor/tiled,/area/space)
"bW" = (/obj/machinery/atmospherics/pipe/simple/hidden/supply{dir = 9; pixel_y = 0},/obj/structure/cable{d1 = 1; d2 = 2; icon_state = "1-2"; pixel_y = 0},/turf/simulated/floor/tiled,/area/space)
"bX" = (/obj/machinery/atmospherics/unary/vent_pump/on{dir = 1},/turf/simulated/floor/tiled/monotile,/area/hallway/primary)
"bY" = (/obj/structure/cable{d1 = 1; d2 = 2; icon_state = "1-2"; pixel_y = 0},/turf/simulated/floor/tiled,/area/space)
"bZ" = (/obj/machinery/atmospherics/unary/vent_pump/on{dir = 1; layer = 2.4; level = 2},/turf/simulated/floor/tiled,/area/space)
"ca" = (/obj/effect/catwalk_plated,/turf/simulated/floor/plating,/area/hallway/primary)
"cb" = (/obj/machinery/atmospherics/pipe/simple/hidden/supply{dir = 5},/turf/simulated/floor/tiled/monotile,/area/hallway/primary)
"cc" = (/obj/machinery/atmospherics/pipe/simple/hidden/supply{dir = 4},/turf/simulated/wall/r_wall/prepainted,/area/space)
"cd" = (/obj/machinery/atmospherics/pipe/simple/hidden/supply{dir = 4},/turf/simulated/floor/tiled,/area/space)
"ce" = (/obj/machinery/atmospherics/unary/vent_pump/on{dir = 8},/turf/simulated/floor/tiled,/area/space)
"cf" = (/obj/machinery/power/apc{dir = 4; name = "east bump"; pixel_x = 24},/turf/simulated/floor/tiled,/area/space)
"cg" = (/obj/machinery/power/apc{dir = 2; name = "south bump"; operating = 1; pixel_y = -28},/obj/structure/cable,/turf/simulated/floor/tiled,/area/space)

(1,1,1) = {"
aaaaaaaaaaaaaaaaaaaaaaaaaaaaaaaaaaaaaaaaaaaaaaaaaaaaaaaaaaaaaaaaaaaaaaaaaaaaaaaaaaaaaaaaaaaaaaaaaaaaaaaaaaaaaaaaaaaaaaaaaaaaaaaaaaaaaaaaaaaaaaaaaaaaaa
aaaaaaaaaaaaaaaaaaaaaaaaaaaaaaaaaaaaaaaaaaaaaaaaaaaaaaaaaaaaaaaaaaaaaaaaaaaaaaaaaaaaaaaaaaaaaaaaaaaaaaaaaaaaaaaaaaaaaaaaaaaaaaaaaaaaaaaaaaaaaaaaaaaaaa
aaaaaaaaaaaaaaaaaaaaaaaaaaaaaaaaaaaaaaaaaaaaaaaaaaaaaaaaaaaaaaaaaaaaaaaaaaaaaaaaaaaaaaaaaaaaaaaaaaaaaaaaaaaaaaaaaaaaaaaaaaaaaaaaaaaaaaaaaaaaaaaaaaaaaa
aaaaaaaaaaaaaaaaaaaaaaaaaaaaaaaaaaaaaaaaaaaaaaaaaaaaaaaaaaaaaaaaaaaaaaaaaaaaaaaaaaaaaaaaaaaaaaaaaaaaaaaaaaaaaaaaaaaaaaaaaaaaaaaaaaaaaaaaaaaaaaaaaaaaaa
aaaaaaaaaaaaaaaaaaaaaaaaaaaaaaaaaaaaaaaaaaaaaaaaaaaaaaaaaaaaaaaaaaaaaaaaaaaaaaaaaaaaaaaaaaaaaaaaaaaaaaaaaaaaaaaaaaaaaaaaaaaaaaaaaaaaaaaaaaaaaaaaaaaaaa
aaaaaaaaaaaaaaaaaaaaaaaaaaaaaaaaaaaaaaaaaaaaaaaaaaaaaaaaaaaaaaaaaaaaaaaaaaaaaaaaaaaaaaaaaaaaaaaaaaaaaaaaaaaaaaaaaaaaaaaaaaaaaaaaaaaaaaaaaaaaaaaaaaaaaa
aaaaaaaaaaaaaaaaaaaaaaaaaaaaaaaaaaaaaaaaaaaaaaaaaaaaaaaaaaaaaaaaaaaaaaaaaaaaaaaaaaaaaaaaaaaaaaaaaaaaaaaaaaaaaaaaaaaaaaaaaaaaaaaaaaaaaaaaaaaaaaaaaaaaaa
aaaaaaaaaaaaaaaaaaaaaaaaaaaaaaaaaaaaaaaaaaaaaaaaaaaaaaaaaaaaaaaaaaaaaaaaaaaaaaaaaaaaaaaaaaaaaaaaaaaaaaaaaaaaaaaaaaaaaaaaaaaaaaaaaaaaaaaaaaaaaaaaaaaaaa
aaaaaaaaaaaaaaaaaaaaaaaaaaaaaaaaaaaaaaaaaaaaaaaaaaaaaaaaaaaaaaaaaaaaaaaaaaaaaaaaaaaaaaaaaaaaaaaaaaaaaaaaaaaaaaaaaaaaaaaaaaaaaaaaaaaaaaaaaaaaaaaaaaaaaa
aaaaaaaaaaaaaaaaaaaaaaaaaaaaaaaaaaaaaaaaaaaaaaaaaaaaaaaaaaaaaaaaaaaaaaaaaaaaaaaaaaaaaaaaaaaaaaaaaaaaaaaaaaaaaaaaaaaaaaaaaaaaaaaaaaaaaaaaaaaaaaaaaaaaaa
aaaaaaaaaaaaaaaaaaaaaaaaaaaaaaaaaaaaaaaaaaaaaaaaaaaaaaaaaaaaaaaaaaaaaaaaaaaaaaaaaaaaaaaaaaaaaaaaaaaaaaaaaaaaaaaaaaaaaaaaaaaaaaaaaaaaaaaaaaaaaaaaaaaaaa
aaaaaaaaaaaaaaaaaaaaaaaaaaaaaaaaaaaaaaaaaaaaaaaaaaaaaaaaaaaaaaaaaaaaaaaaaaaaaaaaaaaaaaaaaaaaaaaaaaaaaaaaaaaaaaaaaaaaaaaaaaaaaaaaaaaaaaaaaaaaaaaaaaaaaa
aaaaaaaaaaaaaaaaaaaaaaaaaaaaaaaaaaaaaaaaaaaaaaaaaaaaaaaaaaaaaaaaaaaaaaaaaaaaaaaaaaaaaaaaaaaaaaaaaaaaaaaaaaaaaaaaaaaaaaaaaaaaaaaaaaaaaaaaaaaaaaaaaaaaaa
aaaaaaaaaaaaaaaaaaaaaaaaaaaaaaaaaaaaaaaaaaaaaaaaaaaaaaaaaaaaaaaaaaaaaaaaaaaaaaaaaaaaaaaaaaaaaaaaaaaaaaaaaaaaaaaaaaaaaaaaaaaaaaaaaaaaaaaaaaaaaaaaaaaaaa
aaaaaaaaaaaaaaaaaaaaaaaaaaaaaaaaaaaaaaaaaaaaaaaaaaaaaaaaaaaaaaaaaaaaaaaaaaaaaaaaaaaaaaaaaaaaaaaaaaaaaaaaaaaaaaaaaaaaaaaaaaaaaaaaaaaaaaaaaaaaaaaaaaaaaa
aaaaaaaaaaaaaaaaaaaaaaaaaaaaaaaaaaaaaaaaaaaaaaaaaaaaaaaaaaaaaaaaaaaaaaaaaaaaaaaaaaaaaaaaaaaaaaaaaaaaaaaaaaaaaaaaaaaaaaaaaaaaaaaaaaaaaaaaaaaaaaaaaaaaaa
aaaaaaaaaaaaaaaaaaaaaaaaaaaaaaaaaaaaaaaaaaaaaaaaaaaaaaaaaaaaaaaaaaaaaaaaaaaaaaaaaaaaaaaaaaaaaaaaaaaaaaaaaaaaaaaaaaaaaaaaaaaaaaaaaaaaaaaaaaaaaaaaaaaaaa
aaaaaaaaaaaaaaaaaaaaaaaaaaaaaaaaaaaaaaaaaaaaaaaaaaaaaaaaaaaaaaaaaaaaaaaaaaaaaaaaaaaaaaaaaaaaaaaaaaaaaaaaaaaaaaaaaaaaaaaaaaaaaaaaaaaaaaaaaaaaaaaaaaaaaa
aaaaaaaaaaaaaaaaaaaaaaaaaaaaaaaaaaaaaaaaaaaaaaaaaaaaaaaaaaaaaaaaaaaaaaaaaaaaaaaaaaaaaaaaaaaaaaaaaaaaaaaaaaaaaaaaaaaaaaaaaaaaaaaaaaaaaaaaaaaaaaaaaaaaaa
aaaaaaaaaaaaaaaaaaaaaaaaaaaaaaaaaaaaaaaaaaaaaaaaaaaaaaaaaaaaaaaaaaaaaaaaaaaaaaaaaaaaaaaaaaaaaaaaaaaaaaaaaaaaaaaaaaaaaaaaaaaaaaaaaaaaaaaaaaaaaaaaaaaaaa
aaaaaaaaaaaaaaaaaaaaaaaaaaaaaaaaaaaaaaaaaaaaaaaaaaaaaaaaaaaaaaaaaaaaaaaaaaaaaaaaaaaaaaaaaaaaaaaaaaaaaaaaaaaaaaaaaaaaaaaaaaaaaaaaaaaaaaaaaaaaaaaaaaaaaa
aaaaaaaaaaaaaaaaaaaaaaaaaaaaaaaaaaaaaaaaaaaaaaaaaaaaaaaaaaaaaaaaaaaaaaaaaaaaaaaaaaaaaaaaaaaaaaaaaaaaaaaaaaaaaaaaaaaaaaaaaaaaaaaaaaaaaaaaaaaaaaaaaaaaaa
aaaaaaaaaaaaaaaaaaaaaaaaaaaaaaaaaaaaaaaaaaaaaaaaaaaaaaaaaaaaaaaaaaaaaaaaaaaaaaaaaaaaaaaaaaaaaaaaaaaaaaaaaaaaaaaaaaaaaaaaaaaaaaaaaaaaaaaaaaaaaaaaaaaaaa
aaaaaaaaaaaaaaaaaaaaaaaaaaaaaaaaaaaaaaaaaaaaaaaaaaaaaaaaaaaaaaaaaaaaaaaaaaaaaaaaaaaaaaaaaaaaaaaaaaaaaaaaaaaaaaaaaaaaaaaaaaaaaaaaaaaaaaaaaaaaaaaaaaaaaa
aaaaaaaaaaaaaaaaaaaaaaaaaaaaaaaaaaaaaaaaaaaaaaaaaaaaaaaaaaaaaaaaaaaaaaaaaaaaaaaaaaaaaaaaaaaaaaaaaaaaaaaaaaaaaaaaaaaaaaaaaaaaaaaaaaaaaaaaaaaaaaaaaaaaaa
aaaaaaaaaaaaaaaaaaaaaaaaaaaaaaaaaaaaaaaaaaaaaaaaaaaaaaaaaaaaaaaaaaaaaaaaaaaaaaaaaaaaaaaaaaaaaaaaaaaaaaaaaaaaaaaaaaaaaaaaaaaaaaaaaaaaaaaaaaaaaaaaaaaaaa
aaaaaaaaaaaaaaaaaaaaaaaaaaaaaaaaaaaaaaaaaaaaaaaaaaaaaaaaaaaaaaaaaaaaaaaaaaaaaaaaaaaaaaaaaaaaaaaaaaaaaaaaaaaaaaaaaaaaaaaaaaaaaaaaaaaaaaaaaaaaaaaaaaaaaa
aaaaaaaaaaaaaaaaaaaaaaaaaaaaaaaaaaaaaaaaaaaaaaaaaaaaaaaaaaaaaaaaaaaaaaaaaaaaaaaaaaaaaaaaaaaaaaaaaaaaaaaaaaaaaaaaaaaaaaaaaaaaaaaaaaaaaaaaaaaaaaaaaaaaaa
aaaaaaaaaaaaaaaaaaaaaaaaaaaaaaaaaaaaaaaaabababababababababababababababababababababababababababaaaaaaaaaaaaaaaaaaaaaaaaaaaaaaaaaaaaaaaaaaaaaaaaaaaaaaaa
aaaaaaaaaaaaaaaaaaaaaaaaaaaaaaaaaaaaaaabacacacacacacacacacacalacacacacacadamamaoaraeaeasatauababababababababababababaaaaaaaaaaaaaaaaaaaaaaaaaaaaaaaaaa
aaaaaaaaaaaaaaaaaaaaaaaaaaaaaaaaaaaaabadadadadadadacacavavavavavavavacacadawaxayazaeaeaeaeaeafaeaeaeaeaeaeaeaAaBaaaaaaaaaaaaaaaaaaaaaaaaaaaaaaaaaaaaaa
aaaaaaaaaaaaaaaaaaaaaaaaaaaaaaaaaaabadaeaeaeaeaeadacacavaCaCaCaCaCavacacadaDaEaFahahahahahahafaeaeaeaeaeaeaAaBaaaaaaaaaaaaaaaaaaaaaaaaaaaaaaaaaaaaaaaa
aaaaaaaaaaaaaaaaaaaaaaaaaaaaaaaaabaeaeaeaeaeaeaeadacacavaCaCaCaCaCavacacadaGahahahahahahahahafaeaeaeaeaeaeaAaBaaaaaaaaaaaaaaaaaaaaaaaaaaaaaaaaaaaaaaaa
aaaaaaaaaaaaaaaaaaaaaaaaaaaaaaaaabaeaHaeaeaeaeaeadadaiavaCaCaCaCaCavaiadadaIaJaJaKahahahahahafaeaeaeaeabaAababaaaaaaaaaaaaaaaaaaaaaaaaaaaaaaaaaaaaaaaa
aaaaaaaaaaaaaaaaaaaaaaaaaaaaaaaaabadadaeaLaeaMaeadaNaNavaCaCaCaCaCavaNaNadaOahafafafafafafafabaPaeabababaBaaaaaaaaaaaaaaaaaaaaaaaaaaaaaaaaaaaaaaaaaaaa
aaaaaaaaaaaaaaaaaaaaaaaaaaaaaaabahajadaeaQaRaeadaNaNaNavaSaCagaCaCavaNaNaNaTaUaVaWaWaWaWaWaWaWaWaWaXaaaaaaaaaaaaaaaaaaaaaaaaaaaaaaaaaaaaaaaaaaaaaaaaaa
aaaaaaaaaaaaaaaaaaaaaaaaaaaaabahaYajadadadaZahadaNaNaNavavbababaavavaNaNaNbbaUaVaWaWaWaWaWaWaWaWbcaXaaaaaaaaaaaaaaaaaaaaaaaaaaaaaaaaaaaaaaaaaaaaaaaaaa
aaaaaaaaaaaaaaaaaaaaaaaaaaanahahahahbdbebebfbebebebebebebebgbgbebebebebebebhbebibjbjbkaWaWaWaWaWaWaXaaaaaaaaaaaaaaaaaaaaaaaaaaaaaaaaaaaaaaaaaaaaaaaaaa
aaaaaaaaaaaaaaaaaaaaaaaaaaanahahahblbmbnbobpbobobobobobobobqbrbnbobobobobobsbtbubvbvbvbvbvbvbvbvbwaXaaaaaaaaaaaaaaaaaaaaaaaaaaaaaaaaaaaaaaaaaaaaaaaaaa
aaaaaaaaaaaaaaaaaaaaaaaaaaaaabahbxbyadadakbzadadaNaNaNaNaNaUbAaUaNaNaNaNaNbBaUaVaWaWaWaWaWaWaWaWaWaXaaaaaaaaaaaaaaaaaaaaaaaaaaaaaaaaaaaaaaaaaaaaaaaaaa
aaaaaaaaaaaaaaaaaaaaaaaaaaaaaaabahbCadaeaebDaeadaNaNaNbEbFaUbGaUaNaNaNaNaNbBaUaVaWaWaWaWaWaWaWaWaWaXaaaaaaaaaaaaaaaaaaaaaaaaaaaaaaaaaaaaaaaaaaaaaaaaaa
aaaaaaaaaaaaaaaaaaaaaaaaaaaaaaaaabadadaeaebDaeaebHaNbIbJbJbKbLbKbJbJbMaNbHbBaUaVaWaWaWaWaWaWaWaWaWaXaaaaaaaaaaaaaaaaaaaaaaaaaaaaaaaaaaaaaaaaaaaaaaaaaa
aaaaaaaaaaaaaaaaaaaaaaaaaaaaaaaaabaeaeaebNbObPaeadadbQadadaUbRaUadadbQadadbSbTaVaWaWaWaWaWaWaWaWaWaXaaaaaaaaaaaaaaaaaaaaaaaaaaaaaaaaaaaaaaaaaaaaaaaaaa
aaaaaaaaaaaaaaaaaaaaaaaaaaaaaaaaabaeaebUbOaeaeaeadaebVaRadaUaUaUadbNbWaeadbXbBafafafafafafafafaeaeabaaaaaaaaaaaaaaaaaaaaaaaaaaaaaaaaaaaaaaaaaaaaaaaaaa
aaaaaaaaaaaaaaaaaaaaaaaaaaaaaaaaaaabaeaeaeaeaeaeadbPbYbZadaUcaaUadbZbYbPadaUcbcccdcdceaeaeaeafaecfabaaaaaaaaaaaaaaaaaaaaaaaaaaaaaaaaaaaaaaaaaaaaaaaaaa
aaaaaaaaaaaaaaaaaaaaaaaaaaaaaaaaaaaaabaeaeaeaeaeadaecgaeadaUcaaUadaecgaeadaUaUafaeaeaeaeaeaeafaeaeabaaaaaaaaaaaaaaaaaaaaaaaaaaaaaaaaaaaaaaaaaaaaaaaaaa
aaaaaaaaaaaaaaaaaaaaaaaaaaaaaaaaaaaaaaabafakahafafafafafafafaqafafafafafafakahafafafaqafafafafaeaeabaaaaaaaaaaaaaaaaaaaaaaaaaaaaaaaaaaaaaaaaaaaaaaaaaa
aaaaaaaaaaaaaaaaaaaaaaaaaaaaaaaaaaabababahahahahahahahahahahapahahahahahahahahahahahahahahahafaeaeabaaaaaaaaaaaaaaaaaaaaaaaaaaaaaaaaaaaaaaaaaaaaaaaaaa
aaaaaaaaaaaaaaaaaaaaaaaaaaaaaaaaaaabahahahahahahahahahahahahapahahahahahahahahahahahahahahahafaPaeabababaBaaaaaaaaaaaaaaaaaaaaaaaaaaaaaaaaaaaaaaaaaaaa
aaaaaaaaaaaaaaaaaaaaaaaaaaaaaaaaabahaeaeaeaeaeaeaeaeaeaeahahaeahahaeaeaeaeaeaeaeaeaeaeaeahahafaeaeaeaeabaAababaaaaaaaaaaaaaaaaaaaaaaaaaaaaaaaaaaaaaaaa
aaaaaaaaaaaaaaaaaaaaaaaaaaaaaaaaabahaeaeaeaeaeaeaeaeaeaeahahaeahahaeaeaeaeaeaeaeaeaeaeaeahahafaeaeaeaeaeaeaAaBaaaaaaaaaaaaaaaaaaaaaaaaaaaaaaaaaaaaaaaa
aaaaaaaaaaaaaaaaaaaaaaaaaaaaaaaaabahaeaeaeaeaeaeaeaeaeaeahahaeahahaeaeaeaeaeaeaeaeaeaeaeahahafaeaeaeaeaeaeaAaBaaaaaaaaaaaaaaaaaaaaaaaaaaaaaaaaaaaaaaaa
aaaaaaaaaaaaaaaaaaaaaaaaaaaaaaaaabahaeaeaeaeaeaeaeaeaeaeahahaeahahaeaeaeaeaeaeaeaeaeaeaeahahafaeaeaeaeaeaeaeaAaBaaaaaaaaaaaaaaaaaaaaaaaaaaaaaaaaaaaaaa
aaaaaaaaaaaaaaaaaaaaaaaaaaaaaaaaabahaeaeaeaeaeaeaeaeaeaeahahaeahahaeaeaeaeaeaeaeaeaeaeaeahahababababababababababababaaaaaaaaaaaaaaaaaaaaaaaaaaaaaaaaaa
aaaaaaaaaaaaaaaaaaaaaaaaaaaaaaaaabahahahahahahahahahahahahahahahahahahahahahahahahahahahahahabaaaaaaaaaaaaaaaaaaaaaaaaaaaaaaaaaaaaaaaaaaaaaaaaaaaaaaaa
aaaaaaaaaaaaaaaaaaaaaaaaaaaaaaaaabababababababababababababababababababababababababababababababaaaaaaaaaaaaaaaaaaaaaaaaaaaaaaaaaaaaaaaaaaaaaaaaaaaaaaaa
aaaaaaaaaaaaaaaaaaaaaaaaaaaaaaaaaaaaaaaaaaaaaaaaaaaaaaaaaaaaaaaaaaaaaaaaaaaaaaaaaaaaaaaaaaaaaaaaaaaaaaaaaaaaaaaaaaaaaaaaaaaaaaaaaaaaaaaaaaaaaaaaaaaaaa
aaaaaaaaaaaaaaaaaaaaaaaaaaaaaaaaaaaaaaaaaaaaaaaaaaaaaaaaaaaaaaaaaaaaaaaaaaaaaaaaaaaaaaaaaaaaaaaaaaaaaaaaaaaaaaaaaaaaaaaaaaaaaaaaaaaaaaaaaaaaaaaaaaaaaa
aaaaaaaaaaaaaaaaaaaaaaaaaaaaaaaaaaaaaaaaaaaaaaaaaaaaaaaaaaaaaaaaaaaaaaaaaaaaaaaaaaaaaaaaaaaaaaaaaaaaaaaaaaaaaaaaaaaaaaaaaaaaaaaaaaaaaaaaaaaaaaaaaaaaaa
aaaaaaaaaaaaaaaaaaaaaaaaaaaaaaaaaaaaaaaaaaaaaaaaaaaaaaaaaaaaaaaaaaaaaaaaaaaaaaaaaaaaaaaaaaaaaaaaaaaaaaaaaaaaaaaaaaaaaaaaaaaaaaaaaaaaaaaaaaaaaaaaaaaaaa
aaaaaaaaaaaaaaaaaaaaaaaaaaaaaaaaaaaaaaaaaaaaaaaaaaaaaaaaaaaaaaaaaaaaaaaaaaaaaaaaaaaaaaaaaaaaaaaaaaaaaaaaaaaaaaaaaaaaaaaaaaaaaaaaaaaaaaaaaaaaaaaaaaaaaa
aaaaaaaaaaaaaaaaaaaaaaaaaaaaaaaaaaaaaaaaaaaaaaaaaaaaaaaaaaaaaaaaaaaaaaaaaaaaaaaaaaaaaaaaaaaaaaaaaaaaaaaaaaaaaaaaaaaaaaaaaaaaaaaaaaaaaaaaaaaaaaaaaaaaaa
aaaaaaaaaaaaaaaaaaaaaaaaaaaaaaaaaaaaaaaaaaaaaaaaaaaaaaaaaaaaaaaaaaaaaaaaaaaaaaaaaaaaaaaaaaaaaaaaaaaaaaaaaaaaaaaaaaaaaaaaaaaaaaaaaaaaaaaaaaaaaaaaaaaaaa
aaaaaaaaaaaaaaaaaaaaaaaaaaaaaaaaaaaaaaaaaaaaaaaaaaaaaaaaaaaaaaaaaaaaaaaaaaaaaaaaaaaaaaaaaaaaaaaaaaaaaaaaaaaaaaaaaaaaaaaaaaaaaaaaaaaaaaaaaaaaaaaaaaaaaa
aaaaaaaaaaaaaaaaaaaaaaaaaaaaaaaaaaaaaaaaaaaaaaaaaaaaaaaaaaaaaaaaaaaaaaaaaaaaaaaaaaaaaaaaaaaaaaaaaaaaaaaaaaaaaaaaaaaaaaaaaaaaaaaaaaaaaaaaaaaaaaaaaaaaaa
aaaaaaaaaaaaaaaaaaaaaaaaaaaaaaaaaaaaaaaaaaaaaaaaaaaaaaaaaaaaaaaaaaaaaaaaaaaaaaaaaaaaaaaaaaaaaaaaaaaaaaaaaaaaaaaaaaaaaaaaaaaaaaaaaaaaaaaaaaaaaaaaaaaaaa
aaaaaaaaaaaaaaaaaaaaaaaaaaaaaaaaaaaaaaaaaaaaaaaaaaaaaaaaaaaaaaaaaaaaaaaaaaaaaaaaaaaaaaaaaaaaaaaaaaaaaaaaaaaaaaaaaaaaaaaaaaaaaaaaaaaaaaaaaaaaaaaaaaaaaa
aaaaaaaaaaaaaaaaaaaaaaaaaaaaaaaaaaaaaaaaaaaaaaaaaaaaaaaaaaaaaaaaaaaaaaaaaaaaaaaaaaaaaaaaaaaaaaaaaaaaaaaaaaaaaaaaaaaaaaaaaaaaaaaaaaaaaaaaaaaaaaaaaaaaaa
aaaaaaaaaaaaaaaaaaaaaaaaaaaaaaaaaaaaaaaaaaaaaaaaaaaaaaaaaaaaaaaaaaaaaaaaaaaaaaaaaaaaaaaaaaaaaaaaaaaaaaaaaaaaaaaaaaaaaaaaaaaaaaaaaaaaaaaaaaaaaaaaaaaaaa
aaaaaaaaaaaaaaaaaaaaaaaaaaaaaaaaaaaaaaaaaaaaaaaaaaaaaaaaaaaaaaaaaaaaaaaaaaaaaaaaaaaaaaaaaaaaaaaaaaaaaaaaaaaaaaaaaaaaaaaaaaaaaaaaaaaaaaaaaaaaaaaaaaaaaa
aaaaaaaaaaaaaaaaaaaaaaaaaaaaaaaaaaaaaaaaaaaaaaaaaaaaaaaaaaaaaaaaaaaaaaaaaaaaaaaaaaaaaaaaaaaaaaaaaaaaaaaaaaaaaaaaaaaaaaaaaaaaaaaaaaaaaaaaaaaaaaaaaaaaaa
aaaaaaaaaaaaaaaaaaaaaaaaaaaaaaaaaaaaaaaaaaaaaaaaaaaaaaaaaaaaaaaaaaaaaaaaaaaaaaaaaaaaaaaaaaaaaaaaaaaaaaaaaaaaaaaaaaaaaaaaaaaaaaaaaaaaaaaaaaaaaaaaaaaaaa
aaaaaaaaaaaaaaaaaaaaaaaaaaaaaaaaaaaaaaaaaaaaaaaaaaaaaaaaaaaaaaaaaaaaaaaaaaaaaaaaaaaaaaaaaaaaaaaaaaaaaaaaaaaaaaaaaaaaaaaaaaaaaaaaaaaaaaaaaaaaaaaaaaaaaa
aaaaaaaaaaaaaaaaaaaaaaaaaaaaaaaaaaaaaaaaaaaaaaaaaaaaaaaaaaaaaaaaaaaaaaaaaaaaaaaaaaaaaaaaaaaaaaaaaaaaaaaaaaaaaaaaaaaaaaaaaaaaaaaaaaaaaaaaaaaaaaaaaaaaaa
aaaaaaaaaaaaaaaaaaaaaaaaaaaaaaaaaaaaaaaaaaaaaaaaaaaaaaaaaaaaaaaaaaaaaaaaaaaaaaaaaaaaaaaaaaaaaaaaaaaaaaaaaaaaaaaaaaaaaaaaaaaaaaaaaaaaaaaaaaaaaaaaaaaaaa
"}
