"a" = (/turf/space,/area/space)
"b" = (/turf/simulated/wall/r_wall/hull,/area/space)
"c" = (/turf/simulated/floor/plating,/area/space)
"d" = (/turf/simulated/wall/prepainted,/area/space)
"e" = (/turf/simulated/floor/tiled,/area/space)
"f" = (/turf/simulated/wall/r_wall/prepainted,/area/space)
"g" = (/turf/unsimulated/mask,/area/space)
"h" = (/turf/simulated/floor/tiled/monotile,/area/space)
"i" = (/obj/machinery/door/airlock/hatch/maintenance,/turf/simulated/floor/plating,/area/space)
"j" = (/turf/simulated/floor/grass,/area/space)
"k" = (/obj/machinery/door/airlock/multi_tile/civilian,/turf/simulated/floor/tiled/monotile,/area/space)
"l" = (/obj/turbolift_map_holder/torch,/turf/unsimulated/mask,/area/space)
"m" = (/turf/simulated/floor/tiled/steel_ridged,/area/space)
"n" = (/obj/effect/wallframe_spawn/reinforced/hull,/turf/simulated/floor/plating,/area/space)
"o" = (/obj/machinery/door/airlock/multi_tile/civilian{dir = 4},/turf/simulated/floor/tiled/monotile,/area/space)
"p" = (/obj/effect/catwalk_plated,/turf/simulated/floor/plating,/area/space)
"q" = (/obj/machinery/door/airlock/civilian,/turf/simulated/floor/tiled/monotile,/area/space)

(1,1,1) = {"
aaaaaaaaaaaaaaaaaaaaaaaaaaaaaaaaaaaaaaaaaaaaaaaaaaaaaaaaaaaaaaaaaaaaaaaaaaa
aaaaaaaaaaaaaaaaaaaaaaaaaaaaaaaaaaaaaaaaaaaaaaaaaaaaaaaaaaaaaaaaaaaaaaaaaaa
aaaaaaaaaaaaaaaaaaaaaaaaaaaaaaaaaaaaaaaaaaaaaaaaaaaaaaaaaaaaaaaaaaaaaaaaaaa
aaaaaaaaaaaaaaaaaaaaaaaaaaaaaaaaaaaaaaaaaaaaaaaaaaaaaaaaaaaaaaaaaaaaaaaaaaa
aaaaaaaaaaaaaaaaaaaaaaaaaaaaaaaaaaaaaaaaaaaaaaaaaaaaaaaaaaaaaaaaaaaaaaaaaaa
aaaaaaaaaaaaaaaaaaaaaaaaaaaaaaaaaaaaaaaaaaaaaaaaaaaaaaaaaaaaaaaaaaaaaaaaaaa
aaaaaaaaaaaaaaaaaaaaaaaaaaaaaaaaaaaaaaaaaaaaaaaaaaaaaaaaaaaaaaaaaaaaaaaaaaa
aaaaaaaaaaaaaaaaaaaaaaaaaaaaaaaaaaaaaaaaaaaaaaaaaaaaaaaaaaaaaaaaaaaaaaaaaaa
aaaaaaaaaaaaaaaaaaaaaaaaaaaaaaaaaaaaaaaaaaaaaaaaaaaaaaaaaaaaaaaaaaaaaaaaaaa
aaaaaaaaaaaaaaaaaaaaaaaaaaaaaaaaaaaaaaaaaaaaaaaaaaaaaaaaaaaaaaaaaaaaaaaaaaa
aaaaaaaaaaaaaaaaaaaaaaaaaaaaaaaaaaaaaaaaaaaaaaaaaaaaaaaaaaaaaaaaaaaaaaaaaaa
aaaaaaaaaaaaaaaaaaaaaaaaaaaaaaaaaaaaaaaaaaaaaaaaaaaaaaaaaaaaaaaaaaaaaaaaaaa
aaaaaaaaaaaaaaaaaaaaaaaaaaaaaaaaaaaaaaaaaaaaaaaaaaaaaaaaaaaaaaaaaaaaaaaaaaa
aaaaaaaaaaaaaaaaaaaaaaaaaaaaaaaaaaaaaaaaaaaaaaaaaaaaaaaaaaaaaaaaaaaaaaaaaaa
aaaaaaaaaaaaaaaaaaaaaaaaaaaaaaaaaaaaaaaaaaaaaaaaaaaaaaaaaaaaaaaaaaaaaaaaaaa
aaaaaaaaaaaaaaaaaaaaaaaaaaaaaaaaaaaaaaaaaaaaaaaaaaaaaaaaaaaaaaaaaaaaaaaaaaa
aaaaaaaaaaaaaaaaaaaaaaaaaaaaaaaaaaaaaaaaaaaaaaaaaaaaaaaaaaaaaaaaaaaaaaaaaaa
aaaaaaaaaaaaaaaaaaaaaaaaaaaaaaaaaaaaaaaaaaaaaaaaaaaaaaaaaaaaaaaaaaaaaaaaaaa
aaaaaaaaaaaaaaaaaaaaaaaaaaaaaaaaaaaaaaaaaaaaaaaaaaaaaaaaaaaaaaaaaaaaaaaaaaa
aaaaaaaaaaaaaaaaaaaaaaaaaaaaaaaaaaaaaaaaaaaaaaaaaaaaaaaaaaaaaaaaaaaaaaaaaaa
aaaaaaaaaaaaaaaaaaaaaaaaaaaaaaaaaaaaaaaaaaaaaaaaaaaaaaaaaaaaaaaaaaaaaaaaaaa
aaaaaaaaaaaaaaaaaaaaaaaaaaaaaaaaaaaaaaaaaaaaaaaaaaaaaaaaaaaaaaaaaaaaaaaaaaa
aaaaaaaaaaaaaaaaaaaaaaaaaaaaaaaaaaaaaaaaaaaaaaaaaaaaaaaaaaaaaaaaaaaaaaaaaaa
aaaaaaaaaaaaaaaaaaaaaaaaaaaaaaaaaaaaaaaaaaaaaaaaaaaaaaaaaaaaaaaaaaaaaaaaaaa
aaaaaaaaaaaaaaaaaaaaaaaaaaaaaaaaaaaaaaaaaaaaaaaaaaaaaaaaaaaaaaaaaaaaaaaaaaa
aaaaaaaaaaaaaaaaaaaaaaaaaaaaaaaaaaaaaaaaaaaaaaaaaaaaaaaaaaaaaaaaaaaaaaaaaaa
aaaaaaaaaaaaaaaaaaaaaaaaaaaaaaaaaaaaaaaaaaaaaaaaaaaaaaaaaaaaaaaaaaaaaaaaaaa
aaaaaaaaaaaaaaaaaaaaaaaaaaaaaaaaaaaaaaaaaaaaaaaaaaaaaaaaaaaaaaaaaaaaaaaaaaa
aaaaaaaaaaaaaaaaaaaabbbbbbbbbbbbbbbbbbbbbbbbbbbaaaaaaaaaaaaaaaaaaaaaaaaaaaa
aaaaaaaaaaaaaaaaaaabccccccccccccccccdeeeeeeeeebbbbbbbbbbaaaaaaaaaaaaaaaaaaa
aaaaaaaaaaaaaaaaaabddddddccfffffffccdeeeeeeeeefeeeeeeeebaaaaaaaaaaaaaaaaaaa
aaaaaaaaaaaaaaaaabdeeeeedccfgggggfccdhhhhhhhhhfeeeeeeebaaaaaaaaaaaaaaaaaaaa
aaaaaaaaaaaaaaaabeeeeeeedccfgggggfccdhhhhhhhhhfeeeeeeebaaaaaaaaaaaaaaaaaaaa
aaaaaaaaaaaaaaaabeeeeeeeddifgggggfiddhhffffffffeeeebbbaaaaaaaaaaaaaaaaaaaaa
aaaaaaaaaaaaaaaabddeeeeedjjfgggggfjjdkhfeeeeeebbbbbbaaaaaaaaaaaaaaaaaaaaaaa
aaaaaaaaaaaaaaabhjdeeeedjjjflggggfjjjhhfeeeeeebaaaaaaaaaaaaaaaaaaaaaaaaaaaa
aaaaaaaaaaaaaabhhjdddkhdjjjffmmmffjjjhhfeeeeeebaaaaaaaaaaaaaaaaaaaaaaaaaaaa
aaaaaaaaaaaaanhhhhhhhhhhhhhhhhhhhhhhhhhheeeeeebaaaaaaaaaaaaaaaaaaaaaaaaaaaa
aaaaaaaaaaaaanhhhohhhhhhhhhhhhphhhhhhhoheeeeeebaaaaaaaaaaaaaaaaaaaaaaaaaaaa
aaaaaaaaaaaaaabhhjddkhddjjjjjhphjjjjjhhfeeeeeebaaaaaaaaaaaaaaaaaaaaaaaaaaaa
aaaaaaaaaaaaaaabhjdeeeedjjjjjhhhjjjjjhhfeeeeeebaaaaaaaaaaaaaaaaaaaaaaaaaaaa
aaaaaaaaaaaaaaaabddeeeeedjjjjhphjjjjdhhfeeeeeebaaaaaaaaaaaaaaaaaaaaaaaaaaaa
aaaaaaaaaaaaaaaabeeeeeeeddqddhphddqddhhfeeeeeebaaaaaaaaaaaaaaaaaaaaaaaaaaaa
aaaaaaaaaaaaaaaabeeeeeeedeeedhhhdeeedhhfeeeeeebaaaaaaaaaaaaaaaaaaaaaaaaaaaa
aaaaaaaaaaaaaaaaabeeeeeedeeedhphdeeedhhfeeeeeebaaaaaaaaaaaaaaaaaaaaaaaaaaaa
aaaaaaaaaaaaaaaaaabeeeeedeeedhphdeeedhhfeeeeeebaaaaaaaaaaaaaaaaaaaaaaaaaaaa
aaaaaaaaaaaaaaaaaaabffffffffffqffffffkhffffffbaaaaaaaaaaaaaaaaaaaaaaaaaaaaa
aaaaaaaaaaaaaaaaabbbhhhhhhhhhhphhhhhhhhhhhhhhhbaaaaaaaaaaaaaaaaaaaaaaaaaaaa
aaaaaaaaaaaaaaaaabeeeeeeeeeehhphhhhhhhhhhhhhhhbbbbbbaaaaaaaaaaaaaaaaaaaaaaa
aaaaaaaaaaaaaaaabheeeeeeeeeehhehhhhhhhhhhhhhhhfeeeebbbaaaaaaaaaaaaaaaaaaaaa
aaaaaaaaaaaaaaaabheeeeeeeeeehhehhhhhhhhhhhhhhhfeeeeeeebaaaaaaaaaaaaaaaaaaaa
aaaaaaaaaaaaaaaabheeeeeeeeeehhehhhhhhhhhhhhhhhfeeeeeeebaaaaaaaaaaaaaaaaaaaa
aaaaaaaaaaaaaaabhheeeeeeeeeehhehhhhhhhhhhhhhhhfeeeeeeeebaaaaaaaaaaaaaaaaaaa
aaaaaaaaaaaaaaabhhhhhhhhhhhhhhehhhhhhhhhhhhhhhbbbbbbbbbbaaaaaaaaaaaaaaaaaaa
aaaaaaaaaaaaaaabbbbbbbbbbbbbbbbbbbbbbbbbbbbbbbbaaaaaaaaaaaaaaaaaaaaaaaaaaaa
aaaaaaaaaaaaaaaaaaaaaaaaaaaaaaaaaaaaaaaaaaaaaaaaaaaaaaaaaaaaaaaaaaaaaaaaaaa
aaaaaaaaaaaaaaaaaaaaaaaaaaaaaaaaaaaaaaaaaaaaaaaaaaaaaaaaaaaaaaaaaaaaaaaaaaa
aaaaaaaaaaaaaaaaaaaaaaaaaaaaaaaaaaaaaaaaaaaaaaaaaaaaaaaaaaaaaaaaaaaaaaaaaaa
aaaaaaaaaaaaaaaaaaaaaaaaaaaaaaaaaaaaaaaaaaaaaaaaaaaaaaaaaaaaaaaaaaaaaaaaaaa
aaaaaaaaaaaaaaaaaaaaaaaaaaaaaaaaaaaaaaaaaaaaaaaaaaaaaaaaaaaaaaaaaaaaaaaaaaa
aaaaaaaaaaaaaaaaaaaaaaaaaaaaaaaaaaaaaaaaaaaaaaaaaaaaaaaaaaaaaaaaaaaaaaaaaaa
aaaaaaaaaaaaaaaaaaaaaaaaaaaaaaaaaaaaaaaaaaaaaaaaaaaaaaaaaaaaaaaaaaaaaaaaaaa
aaaaaaaaaaaaaaaaaaaaaaaaaaaaaaaaaaaaaaaaaaaaaaaaaaaaaaaaaaaaaaaaaaaaaaaaaaa
aaaaaaaaaaaaaaaaaaaaaaaaaaaaaaaaaaaaaaaaaaaaaaaaaaaaaaaaaaaaaaaaaaaaaaaaaaa
aaaaaaaaaaaaaaaaaaaaaaaaaaaaaaaaaaaaaaaaaaaaaaaaaaaaaaaaaaaaaaaaaaaaaaaaaaa
aaaaaaaaaaaaaaaaaaaaaaaaaaaaaaaaaaaaaaaaaaaaaaaaaaaaaaaaaaaaaaaaaaaaaaaaaaa
aaaaaaaaaaaaaaaaaaaaaaaaaaaaaaaaaaaaaaaaaaaaaaaaaaaaaaaaaaaaaaaaaaaaaaaaaaa
aaaaaaaaaaaaaaaaaaaaaaaaaaaaaaaaaaaaaaaaaaaaaaaaaaaaaaaaaaaaaaaaaaaaaaaaaaa
aaaaaaaaaaaaaaaaaaaaaaaaaaaaaaaaaaaaaaaaaaaaaaaaaaaaaaaaaaaaaaaaaaaaaaaaaaa
aaaaaaaaaaaaaaaaaaaaaaaaaaaaaaaaaaaaaaaaaaaaaaaaaaaaaaaaaaaaaaaaaaaaaaaaaaa
aaaaaaaaaaaaaaaaaaaaaaaaaaaaaaaaaaaaaaaaaaaaaaaaaaaaaaaaaaaaaaaaaaaaaaaaaaa
aaaaaaaaaaaaaaaaaaaaaaaaaaaaaaaaaaaaaaaaaaaaaaaaaaaaaaaaaaaaaaaaaaaaaaaaaaa
aaaaaaaaaaaaaaaaaaaaaaaaaaaaaaaaaaaaaaaaaaaaaaaaaaaaaaaaaaaaaaaaaaaaaaaaaaa
aaaaaaaaaaaaaaaaaaaaaaaaaaaaaaaaaaaaaaaaaaaaaaaaaaaaaaaaaaaaaaaaaaaaaaaaaaa
aaaaaaaaaaaaaaaaaaaaaaaaaaaaaaaaaaaaaaaaaaaaaaaaaaaaaaaaaaaaaaaaaaaaaaaaaaa
"}
